.......................
.......................
.......................
.......................
.........^....*........
........%#-.------%....
........%#........%....
@....*..%#........%....
###==#####========#####
#######################S

