.......................
.......................
.......................
.......................
.........^....*./......
........%#-.------%....
........%#........%....
@....*..%#........%....
+++==+++##========#++++
#######################

