..............................................................
..............................................................
..............................................................
......................*.......................................
.................^............................................
................%#-...----%...................................
.............*..%#........%...................................
........@.....s.%#........%.......s...........................
+++++++++++==+++##========#+++++++++++++++++.%++++++++++++++++
############################################.%################
############################################.%################
#################################.....*......%.......#########
#################################............%.....s.#########
##############################################################