%............................................................#
%............................................................#
%............................................................#
%.....................*......................................#
%................^...........................................#
%...............%#-...----%..................................#
%............*..%#........%..................................#
%.......@.....s.%#........%.......s..........................#
#++++++++++==+++##========#+++++++++++++++++.%+++++++++++++++#
############################################.%################
############################################.%################
#################################.....*......%.......#########
#################################............%.....s.#########
##############################################################