..............................................................
..............................................................
..............................................................
......................*.......................................
.................^............................................
................%#-...----%...................................
.............*..%#........%...................................
........@.......%#........%...................................
+++++++++++==+++##========#+++++++++++++++++.%++++++++++++++++
############################################.%################
############################################.%################
#################################.....*......%.......#########
#################################............%.......#########
##############################################################