..............................................................
..............................................................
..............................................................
......................*.......................................
.................^............................................
................%#-..-----%...................................
.............*..%#........%...................................
........@.....s.%#........%.............................s.....
+++++++++++==+++##========#++++++++++++++++..%++++++++++++++++
###########################################..%################
###########################################..%################
#################################....**......%.......#########
#################################..s.........%.......#########
##############################################################