..............................................................
..............................................................
..............................................................
......................*.......................................
.................^............................................
................%#-..-----%...................................
.............*..%#........%...................................
........@.......%#........%...................................
+++++++++++==+++##========#++++++++++++++++..%++++++++++++++++
###########################################..%################
###########################################..%################
#################################.....*......%.......#########
#################################............%.......#########
##############################################################