.............................................................#
....................*........................................#
.......*............................................*........#
.............................................................#
...................................*.........................#
.................%#####......###.....###.....................#
.................%................................**.....s...#
........@........%............s.............................n#
#++++++++++==+++##========#+++++++++++++++++.%+++++++==++++++#
############################################.%################
############################################s%################
##############################################################
##############################################################
##############################################################